10
北京 天津 西安 上海 武汉 成都 昆明 长沙 广州 南京 
0	50	700	-1	800	-1	-1	-1	-1	700
50	0	700	-1	-1	-1	-1	-1	-1	600
700	700	0	-1	400	300	-1	400	-1	700
-1	-1	-1	0	400	-1	-1	500	700	250
800	-1	400	400	0	-1	-1	150	500	250
-1	-1	300	-1	-1	0	500	700	800	-1
-1	-1	-1	-1	-1	500	0	700	700	-1
-1	-1	400	500	150	700	700	0	400	-1
-1	-1	-1	700	500	800	700	400	0	-1
700	600	700	250	250	-1	-1	-1	-1	0